11111111
1000S01
1000001
1000001
1000001
1000001
1000001
1000001
10000011
10000001
10000001
10000011
1000001
1000001
1000001
1000001
1000001
1000001
1000001
1111111