1111111111111
1000000000E1
100000000001
100000000001
100000000001
100000000001
100000000001
100000000001
1000000000011
1000000000001
1000000000001
1000000000011
100000000001
100000000001
100000000001
100000000001
100000000001
100000000001
100000000001
111111111111