11111111
1000001
100N001
1000001
1111111