C 20,30,150
F 220,150,150
11111111111
10000000001
10000000001
10000000001
100000000011
100000000001
100000000001
10000N000011
10000000001
11111111111