F 210,100,0
C 210,100,0
1111111111111
1000000000W1
100000000001
100000000001
100000000001
100000000001
100000000001
100000000001
1000000000011
1000010000001
1000100000001
1001000000011
100000000001
100000000001
100000000001
100000000001
100000000001
100000000001
100000000001
111111111111