    111111         
    1001  
11111011
10N001
111111