11111111111111
1N001
10001
11111