F 220,89,160
C 30,150,20
1111111
100111
10S01
11111