
11111111
10000001
1000N001
11111111