    1001  
    11111111111111      
1111011
100001
111111                      