NO ./img/wall_north.xpm   
    111111         
    1001  
1111011
10N001
111111