F sdhgkdhg
11111111
100111
10N01
11111