    11111         
    1001  
1111011
100001
111111