F 20,89,160
C 230,150,25
1111111
100111
10N01
11111